0 0 0 8 8 8 8 8 8 8 8 8 8 8 8 8 8 8 
0 0 0 1 1 1 1 4 0 1 1 1 1 4 9 9 8 8
0 0 0 5 7 7 7 4 0 5 7 7 7 4 9 8 8 8
0 0 0 5 9 0 0 4 0 5 6 6 0 1 1 1 1 2
0 0 0 5 9 0 0 4 8 8 8 5 0 7 7 7 7 7
0 0 0 5 9 0 0 1 1 1 1 5 0 4 6 6 6 6
0 0 0 5 8 8 8 8 8 8 8 8 8 4 7 7 7 3
0 0 0 5 6 6 6 6 6 6 6 6 6 6 9 9 7 7
0 0 0 7 7 7 7 7 7 7 7 7 7 7 9 9 7 7
0 0 0 7 7 7 7 7 7 7 7 7 7 7 7 7 7 7